







F 164,+169,201

C	153,204,255

NO ./textures/bernoussi.xpm



SO ./textures/mdina_9dima.xpm



WE ./textures/sbata_04.xpm


EA ./textures/inara.xpm

1111111111111111111111111111
1000000000111111000000000001
1000000011111111110000000001
1000000111111111111000000001
1000001111111111111100000001
1000011111111111111110000001
1000011111111111111110000001
1000111111000000111111000001
1000111110000000011111000001
1001111000000000001111100001
1001111000000000001111100001
1011110000000000000111110001
1011110000000000000111110001
1011110000000000000111110001
1011100000000000000011100001
1001100000000000000001100001
1001100000000000000001100001
1001000000000000000001000001
1000000000000000000000000001
1000000000N00000000000000001
1000000000000000000000000001
1000000000000000000000000001
1000000000000000000000000001
1111111111111111111111111111

