







F 164,+169,201

C	153,204,255

NO textures/simonkraft/wet_sponge.xpm

SO textures/simonkraft/wet_sponge.xpm








WE textures/simonkraft/wet_sponge.xpm

EA textures/simonkraft/wet_sponge.xpm

111111111111111111111111111111
100000000000000000000000000001
101111111110000000000011111101
101000000000011111000000000101
101000000000010000000000000101
101000000000011111111100000101
101111111110000000000011111101
100000000000000000000000000001
100000000000011111000000000001
100000000N00000000000000000001
111111111111111111111111111111
100000000000000000000000000001
101111111110000000000011111101
101000000000011111000000000101
101000000000010000000000000101
101000000000011111111100000101
101111111110000000000011111101
100000000000000000000000000001
111111111111111111111111111111
