







F 164,+169,201

C	153,204,255

NO textures/simonkraft/wet_sponge.xpm

SO textures/simonkraft/wet_sponge.xpm








WE textures/simonkraft/wet_sponge.xpm

EA textures/simonkraft/wet_sponge.xpm

111111111 11111111111
101000001000000000001
101010101011111110001
100010100010000010001
111110101111101011101
100000101000101000001
101111101011101111111
101000001010100000101
101011111010111110101
101010001010100010101
11110101W10101010101
100000101010001010001
111111101011111011101
100000101000100010001
101110101110101110111
101000100000100010101
100011111111111010101
100010000000000010001
101010111011111111101
110000010000000000011
1111111111 11111111111