NO ./textures/picture.png
SO ./textures/picture.png
WE ./textures/picture.png
EA ./textures/picture.png
F 95,158,160
C 163, 194, 194
11111111111111111111111111111
10000000001100000000000000001
1001S000011101000000000010101
10010000000000000000000010001
10110000011100000000000010001
10000000001100000111011110001
11110111111111011100000010001
11110111111111011101010010001
11000000110101011100000010001
10001000000000001100000010001
10000000000000001101010010001
11010000110101000000000000001
11110111110101000000000000001
10000000001100000100100010001
10000000000000001010000101001
10100000001000010001010001001
10000000001101000100000100101
10000000000100000001010000001
11111111111111111111111111111