NO ./textures/sbata_04_tag1.png
EA ./textures/sbata_04_tag2.png
WE ./textures/sbata_04_tag3.png
SO ./textures/sbata_04_tag4.png
F 95,158,160
C 163, 194, 194
11111111111111111111111111111
10000000001100000000000000001
1011000001110000000000010001
1001000000000000000000010001
1011000001110000000000010011
10000000001100000111011110001
11110111111111011100000010001
11110111111111011101010010001
110000000110101011100000010001
10000000000000001100000010001
10000000000000001101010010001
10000000000000001101010010N01
11000000110101011111011110001
11110111111101011111011110001
111111111100000100011111111111
10000000000000011000000100011
100000000000010001101010010001
11111111111111111111111111111