







F 164,+169,201

C	153,204,255

NO textures/simonkraft/wet_sponge.xpm

SO textures/simonkraft/wet_sponge.xpm








WE textures/simonkraft/wet_sponge.xpm

EA textures/simonkraft/wet_sponge.xpm

111111111111111111111
101000001000000000001
101010101011111110001
100010100010000010001
111110101101101011101
100000101010101000001
101111101011101111111
101000001010100000101
101011111010111110101
101010001010100010101
101110101010101010101
100000101010001010001
111111101011111011101
100001 11000100010001
101110101110101110111
101000100000100010101
101011111111111010101
100101000000000001001
110101110111111111011
1N1000001000000001001
111111111111111111111