NO ./textures/mdina_9dima.png
EA ./textures/sbata_04.png
WE ./textures/inara.png
SO ./textures/bernoussi.png
F 95,158,160
C 163, 194, 194
 1111111111111111111111111         
   10000000000000000000001      
  1000000000000001000000001      
 1000000000000000000000001
1000000000000000000000001
 1000000000001000000000001
  1000000000000000000000001
   1000000000000000000000001
  1000000000000000000000001
 100000000000N000000000001
1111111111111111111111111
