NO ./path_to_the_north_texture
F 220,100,0
SO ./path_to_the_south_texture
WE ./path_to_the_west_texture
C 225,30,0
EA ./path_to_the_east_texture
1111111111111111111111111
1000000000110000000000001
1011000001110000000000001
1001000000000000000000001
1111111110110000011100000000000011
1000000000110001001110111111111
11110111111111011100000010001
11110111111110111101010010001
1100000011010 011100000010001
1000000000001001100000010001
10000000000000001101010010001
11000001110101011111011110N0111
11110111 1110101 101111010001
11111111 1111111 111111111111
