NO ./path_to_the_north_texture
SO ./path_to_the_south_texture
WE ./path_to_the_west_texture
EA ./path_to_the_east_texture
F 255,100,10
C 225,30,0

1111111111  1111111111111
	1000000000110000000000001
	1011000001110000000000001
	1001000000000000000000001
	111111111011000001110000000000001
100000000011000001110111111111111
1111011E111111011100000010001
1111011111111101110101001000111111
11000000110101011100000010001
10000000000000001100000010001
10000000000000001101010010001
1100000111010101111101111010111
11110111 1110101 101111010001
11111111 1111111 110111111111