SO textures/test/south.xpm
WE textures/test/west.xpm
EA textures/test/east.xpm
NO textures/test/east.xpm

F 20,20,+20
C -200, 200,200

101000001000000000001
101010101011111110001
100010100010000010001
111110101111101011101
100000101000101000001
101111101011101111111
101000001010100000101
101011111010111110101
101010001010100010101
101110101010101010101
111111111111111111111